0000000000000000000000000000000000000000000000000000000000000000000000000000000000000000000000
0000000000000000000000000000000000000000000000000000000000000000000000000000000000000000000000
0000000000000000000000000000000003000000000000000000000002000000000000000000000000000000300000
0000000000000000000000001111111111111111111111111111111111111111111111111111111111111111111111
0000000000000000000000000000000000000000000000000000000000000000000000000000000000000000000000
0000200000000300000000000000000000000000000000000000000000000000000000000000000000000000000000
1111111111111111111111111111111111111111111111111000000000000000000000000000000000000000000000
0000000000000000000000000000000000000000000000011000000300000000000000000000000000000000000000
0000030000000020000000000000000000000000000000011111111111111110000000000000000000000000000000
1111111111111111111100000000000000000000000000011000000000000000000000000000000000000000000000
0000000000000000000000000000000000000000000000011000000000000000000000200000000000000003000000
0000000000000000000000000000000000000000000000011000000000011111111111111111111111111111111111
0000000000000000000000111111111111111111111111111000000000000000000000000000000000000000000000
0000000000000000000000000000000000000000000000011000030000000000000000000000000000000000000000
0000000002000000000000030000000000000000000000011111111111111111100000000000000000000000000000
1111111111111111111111111111100000000000000000011000000000000000000000000000000000000000000000
0000000000000000000000000000000000000000000000011000000000000000000000000000000000000200000000
0000300000000000000000000000000000000000000000011000000000000000000011111111111111111111111111
1111111111110001111111111111111111111000000000011000020000011111000000000000000000000000000000
0000000000000010000000000000000011111100000000011111111111111111100000000000000000000000000000
0000000000000000000000000000000000000000000000000000000000000000000000000000000000000000000000
0000000000000000000000000000000000000000000000000000000000000000000000000000000000000000000000
1111111111111111111111111111111111111111111000001111111111111111111111111111111111111111111111
0000000000000000000000000000000000000000000000000000000000000000000000000000000000000000000000
0000000000000300000000000000000000000000000000000000000000000000000000000000000000000000000000
0000000011111111111111111111111111111111111111111111111111111100000030000002000000000000002000
0000000000000000000000000000000000000000000000000000000000000110011111100011111000001111111111
0000000000000000000000000000000000000000000000000000000000000000000000000000000000000000000000
0000030000000000200000000000000000000000000000000000000300000000000000000000000000000000000000
1111111111111111111111111110000000000000000000111111111111111111111111111111111111111111111111
1111111111111111111111111111111111000000001111110000000000000000000000000000000000000000000000
0000000000000000000000000000000000000000000000110000000000000000000000000000000000000000000000
0000000000000000000000000000000000000000000000110000020000030000000000000000000000000000000000
0000000020000000000000000000000000000111111111111111111111111110000000000000000000000000200000
1111111111111111111111000000000000000000000000110000000000000000000000000111111111111111111111
0000000000000000000000000000000000000000000200110002000000000000000000000000000000000000000000
0000000000000000003000000000111111111111111111111111111111111111111110000000000000000000000000
2000000000000011111111110000000000000000000000110000000000000000000000000000300000000000022000
1111111110001100000000000000000000000000000000110000000000000000000000011111111111111111111111
0000000000000000000000000000000000000000000000000000000000000000000000000000000000000000000000
0000300000000000000000000000000000000020000000000000003000000000000000000000000002000000000000