000000000000000000000000000000000000000000000000200000000000000000000000000000000030000000000000000000000000000000000000
000000000000000000000000000000111111111111111111111111111111111111111111111111111111111111000000000000000000000000000000
000002000000000000000000000000000000000000000000000000000000000000000000000000000000000000000000000000000030000000000000
111111111111111111111111110000000000000000000000000000000022000000000000000000000000000000000011111111111111111111111111
000000000000000000000000000000000000000000001111111111111111111111111111111100000000000000000000000000000000000000000000
000000000000000000300000000000000000000000000000000000000000000000000000000000000000000000000000000000000000000020000000
111111111111111111111111111111111111111111000000000000000000000000000000000000111111111111111111111111111111111111111111
000000000000000000000000000000000000000000000000000000000000000000000000000000000000000000000000000000000000000000000000
000000000000000000000000000000000000000000000000000000000000000000000300000000000000000000000000000000000000000000000000
000000000000000000000000000000000000011111111111111111111111111111111111111111111110000000000000000000000000000000000000
000000000000000000300000000000001111111000000000000000000000000000000000000000000111111100000000000003000000000000000000
000000000011111111111111111110000000011220000000000000000000000000000000000000022110000000011111111111111111110000000000
111110000011111111111111111110000000011111111000000000000000000000000000000111111110000000011111111111111111110000011111
000000000000000000000000000000000000011000000000000000000000000000000000000000000110000000000000000000000000000000000000
200000000000000000000000000000000000011000000000000000000000000000000000000000000110000002000000000000000000000000000000
111111111111000011111111111111111111111000000000000111111111111111111000000000000111111111111111111111110000111111111111
000000000000000000000000000000000000000000000000000000000000000000000000000000000000000000000000000000000000000000000000
000020000000000000000000000000000000000000000000000000000003000000000000000000000002000000000000000000000000000002000000
111111111111111111111111000000111111111111111111111111111111111111111111111111111111111111000000111111111111111111111111
000000000000000000000000000000000000000000000000000000000000000000000000000000000000000000000000000000000000000000000000
000000000000000000000000000000000300000000000000000000000000000000000000000000000002000000000000000000000000000000000000
000000000000000001111111111111111111111111111110000000000000000000000000011111111111111111111111111111100000000000000000
000000000000000000000000000000000000000000000000000000000000000000000000000000000000000000000000000000000000000000000000
000000000000003000000000000000000000000000000000000000000000000000000000000000000003000000000000000000000000000000000000
000000011111111111111111111111111111111111111111111111111111111111111111111111111111111111111111111111111111111110000000
000000000000000000000000000000000000000000000000000000000000000000000000000000000000000000000000000000000000000000000000
000020000000000000000000000000000000000000000000000000000003000000000000000000000000000000000000000000000000000000000020
111111111111111111111111111111110000000000000000000111111111111111111000000000000000000011111111111111111111111111111111
000000000000000000000000000000000000000000000000000000000000000000000000000000000000000000000000000000000000000000000000
000000000000003000000000000000000000000000000000000000000030000000000000000000000000000000000000000000000030000000000000