000000000000000000000000300000000000000000000000000000000000000000000000000000000000000300000000000000000000000000000000
000000000000000001111111111111111111110000000000000003000000000000000000000111111111111111111111000000000000000000000000
000000000000000000000000000000000000000001111111111111111111111111111100000000000000000000000000000000000000000000000000
000000000000000000000000000000000000000000000000000000000000000000000000000000000000000000000000000000000000000000000000
111111111111111111111111111111111110000000000000000000000000000000000000000000000000000000000000000000000000000200000000
000000000000000000000000000000000010000000000000000000000000000000001111111111111111111111111111111111111111111111111111
000030000000000000000000000000000012000000000000000000000000000000001100000000000000000000000000000000000000000000000000
111111111111000000000000000000000011111111111111111000000000000000111100000000000000000000000000000000000000000000000000
000000000000000000000000000003000010000000000000000000000000030011111100000000000000000000000000000000000000000220000000
000000000000000000011111111111111110000000000000000000011111111111111100003000000000000000000000001111111111111111111111
200000000000000000000000000000000012000000000000000000000000000000001111111111111111111111110000000000000000000000000000
111111111111110000000000000000000011111111111111111100000000000000001100000000000000000000000000000000000000000020000000
000000000000000000000000000000000000000000000000000000000000000000001100000000000000000000000001111111111111111111111111
000030000000000000000000000000000003000000000000000000000000000000001100030000000000000000000000000000000000000000000000
111111111111111111111111111111111111111111111111111111111100000000001111111111111111111111111000000000000000000000200000
000000000000000000000000000000000000000000000000000000000000000000000000000000000000000000000000000000000001111111111111
000000000000000000000000000000000000000000000000000000000000000000000000000000300000000000000000000000000000000000000002
000000000000000000000000000000000000000000000011111111111111111111111111111111111111111111111111111111111111111111111111
000000000000000000000000200000000000000000000011111111111111111111111111111111111111111111111111111111111111111111111111
000000000000001111111111111111111111100000011111000000000000000000000000000000000000000000000000000000000000000000000000
000000000000000000000000000000000000000000011111000000000000000000000000000000000000000300000000000000000000000000000000
200000000000000000000000000000000000000011111111000003000000000000000000000000011111111111111110000000000000000000000000
111111111111111111110000000001111111111111111111111111111111111110000000000000000000000000000000000000000000000000022000
000000000000000000000000000000000000000000000000000000000000000000000000000000000000000000000000000111111111111111111111
000000000000000000000000000000000000000000000000000000000000000000000000000000000111111000000001111111110000000000000000
111111111111111111111111111111111111111111111111111111111111111111111111110000000000000000000000000000000000000000000000
000000000000000000000000000000000000000000000000000000000000000000000000000000000000000000000000000000000000000003000000
300000000000000000000000000000000000000000000000000000000000000000000000000001111111111111111111111111111111111111111111
111111111111111111111111111111111111111111111111111111111111000000000000000000000000000000000000000000000000000000000000
000000000000000000000000000000000000000000000000000000000000000000000000000000000000000000000000000000000000000000002222