000000000000000000000000000002200000000000000000000000000000000000000000000000000000022000000000000000000000000000000000
000000000000000000011111111111111111111111111100000000000000000000000001111111111111111111111111111000000000000000000000
000000000000000000000000000000000000000000001111000000000000000000000111100000000000000000000000000000000000000000000000
000000000000000000000000003000000000000000001111110000003000000000011111100000000000000300000000000000000000000000000000
000000001111111111111111111111111111111111111111111111111111111111111111111111111111111111111111111111111111100000000000
000000000000000000000000000000000000000000000000000000000000000000000000000000000000000000000000000000000000000000000000
000000020000000000000000000000000000000000000000000000000000000000000000000000000000000000000000000002000000000000000000
111111111111111111111111111111111000000000000000000000000000000000000000000000000000000000011111111111111111111111111111
000000000000000000000000000000000000000000000300000000000003000000000000000003000000000000000000000000000000000000000000
000000000000000000000000000000000001111111111111111111111111111111111111111111111111111110000000000000000000000000000000
000000000000002000000000000000000001100000000000000000000000000000000000000000000000000110000000000000000000000000000000
000000111111111111111111111110000111100000000000000000000000000000000000000000000000000111100011111111111111111110000000
000000000000000000000000000000000000000000000000000000000000000000000000000000000000000000000000000000000000000000000000
000020000000000000000000000000000000000000000000000030000000000000003000000000000000000000000000000000000000000000200000
111111111111111111111111111111111100000000001111111111111111111111111111111110000000000111111111111111111111111111111111
000000000000000000000000000000000000000000000000000000000000000000000000000000000000000000000000000000000000000000000000
000000000000000000000000000000000000000000000000000000000000000000000000000000000000000000000000000000000000000000000000
000000000000000000000000000111111111111111111111111000000000000000000000111111111111111111111110000000000000000000000000
000000000000000000000000000000000000000000000000000000000000000000000000000000000000000000000000000000000000000000000000
220000000000000000000000000000000000000000000000000000000000000000000000000000000000000000000000000000000000000000000022
111111111111111111111111111111111100000000000000000030000000000000000003000000000000001111111111111111111111111111111111
000000000000000000000000000000000000000000000011111111111111111111111111111100000000000000000000000000000000000000000000
000000000000000000000000000000000000000000000011111111111111111111111111111100000000000000000000000000000000000000000000
020000000000000011111111111111111111111111111111111111111111111111111111111111111111111111111111110000000000000000000020
111111111110000000000000000000000000000000000000000000000000000000000000000000000000000000000000000000000111111111111111
111111111111100000000000000000000000000000000000000003000000000000000030000000000000000000000000000000011111111111111111
111111111111111000000000000000000000000000001111111111111111111111111111111111100000000000000000000001111111111111111111
111111111111111111111111111111111100000000111100000000000000000000000000000001111000000000111111111111111111111111111111
000000000000000000000000000000000000000000000000000000000000000000000000000000000000000000000000000000000000000000000000
000000200000000000000000000000000000000000000000000000000000000000000000000000000000000000000000000000000000000020000000